########################
#......#.#......#......#
#.####.#.######.#.####.#
#.#..#........#.#...#..#
#.#..####.#.#.#.#.#.#.#.
#.......#.#.#....#.....#
####.#.###.####.#.######
#......#........#......#
#.#####.######.#.#####.#
#.#...#.#.#....#.#.....#
####.#.#.#.####.#.#.####
#......................#
#.####################.#
#.#..................#..#
#.#.####.######.####.#.#.
#.....#...........#.....#
##################.######
#.......................#
#######.##########.######
#.#.............#........
#.......................#
####.#.############.#####
#.......................#
########################
